##############################
# @ ###$                     #
#   #######################  #
#                            #
#                            #
#                            #
#                            #
#                            #
#                            #
#                            #
#                            #
#                            #
#                            #
#                            #
#            &               #
#            &               #
#            &               #
#                            #
#                            #
#                            #
#                            #
#                            #
#$                          $#
##############################
##############################
##############################
#                            #
#                            #
#                            #
##############################